Név	Tárgy	Azonosító	Jelszó	Vkezdő	Ukezdő	Hanyadik	JelszóBetű	Jelszószám
Blazsetics Viktória	matematika
Kosztolányi Péter	matematika
Nik Izabella	matematika
Török Nóra	fizika
Majoros Márton	informatika
Senkey Kinga	matematika
Reményfi Márton	angol
Kispál Béla	informatika
Ferdinandy Petra	fizika
Pánczél Éva	fizika
Kohlmann Bence	informatika
Polgár Zoltán	matematika
Tóth Mónika	informatika
Túri Péter	matematika
Halmosi Csenge	fizika
Sándor Orsolya	történelem
Józsa Norbert	informatika
Béres Fanni	matematika
Veres Tibor	angol
Varga Roland	történelem
Leindler Éva	matematika
Marsi Vilmos	informatika
Miklós Nándor	informatika
Korcsok Viktor	angol
Füzesy Balázs	történelem
Mazzag Tamás	fizika
Illés Pál	történelem
Cao Ádám	történelem
Rudinszki Orsolya	matematika
Nikk Ferenc	matematika
Török Dániel	matematika
Forgács Márton	matematika
Varga Máté	angol
Szeghalmi Zsolt	matematika
Földesi Béla	fizika
Baranyi Zsanett	angol
Pepó Ervin	történelem
Kiss Mátyás	informatika
Prónay Enikő	matematika
Petres Lajos	fizika
Kovács Ágnes	történelem
Bányai László	fizika
Kondász Kinga	fizika
Papp Attila	történelem
Tóth Anita	fizika
Halász Vid	fizika
Csala Krisztina	matematika
Nádasi Tamara	történelem
Vlad Péter	fizika
Pálos Elek	fizika
Bakó András	informatika
Barlai Gabriella	matematika
Jenet Róbert	történelem
Zsíros Ottó	informatika
Mind Ervin	informatika
Szécsi Zoltán	matematika
Erdélyi Lajos	fizika
Csiszár Mercédesz	matematika
Pálinkó Eszter	informatika
Bild Csilla	informatika
Kovács Borbála	angol
Bereczki Anetta	matematika
Ladányi Kálmán	fizika
Erdélyi Péter	angol
Vidács Valentin	angol
Szednicsek Karl	történelem
Blazsetics Zoltán	informatika
Jenet Timea	informatika
Almási Ádám	fizika
Szabó Nóra	történelem
Terbe László	informatika
Makra Csilla	informatika
Kolláth Ottó	történelem
Gyulai Márton	angol
Fábián Zoltán	informatika
Pelesz Laura	fizika
Molnár Roland	informatika
Kovács Béla	történelem
Ferdinandy Ágnes	fizika
Rózsa Szabolcs	matematika
Hebling Ádám	fizika
Hajas Péter	matematika
Budai Endre	informatika
Kovács Gábor	matematika
Kosztolányi László	matematika
Erdélyi Imre	történelem
Báthori Attila	angol
Pölös Ditta	angol
Bodor Máté	angol
Fabó Tamás	angol
Ferke Dániel	angol
Müller Attila	történelem
Dobó Gusztáv	matematika
Hlavati Balázs	informatika
Nagy Zsolt	fizika
